1111131111
0000000000
0004050000
0011111100
0000000000
0500000500
1110000111
0000600000
0000000000
1111221111