1111131111
0000000000
0000000000
0000540000
0001111000
0000000000
0000600000
0001110000
0500000050
1111221111