0000110000
5555555555
5555555555
5555555555
5500000055
5555555555
5555555555
5555555555
5555555555
0005225000